#############
#        O  #
#   PXX #####
#           #
#######     #
#  O ##   O #
#    ##     #
#           #
#  X    X   #
#O      #   #
#############